Quốc gia,Châu lục,Bia tiêu thụ,Rượu vang tiêu thụ,Rượu mạnh tiêu thụ,Tổng lượng tiêu thụ
Việt Nam,Châu Á,197,1,50,248
Nhật Bản,Châu Á,77,7,22,106
Hàn Quốc,Châu Á,61,9,90,160
Đức,Châu Âu,346,175,90,611
Pháp,Châu Âu,182,370,132,684
Italia,Châu Âu,85,237,42,364
Brazil,Châu Mỹ,245,16,25,286
Argentina,Châu Mỹ,193,221,35,449
Mỹ,Châu Mỹ,249,84,158,491
Nigeria,Châu Phi,36,19,5,60
Nam Phi,Châu Phi,219,36,101,356
Úc,Châu Đại Dương,261,212,133,606
New Zealand,Châu Đại Dương,175,202,87,464